हे|DMR बेट|NN छोटंसं|JJ परंतु|CCD सोनेरी|JJ समुद्राकिनारे|NN आणि|CCD आनंददायी|JJ पोर्तुगीज|NN स्थापत्याची|NN विपुलता|NN असणारं|VM आहे|VAUX .|PUNC
अखेरीस|NN ,|PUNC आराम|NN आणि|CCD मनःशांती|NN साठी|NN निसर्ग|NN उद्याने|NN ,|PUNC शांत|JJ वने|NN आणि|CCD चित्रासारख्या|NN सुंदर|JJ आदिवासी|NN गावांनी|NN युक्त|NN अशा|JJ ,|PUNC हिरव्यागार|NN दादरा|NN आणि|CCD नगर|NN हवेलीला|NN भेट|NN द्या|VM .|PUNC
भारतातील|NNP अत्युत्तम|JJ अनुभव|NN देणा|VM ~|NN या|DMR ठीकाणाशीच|NN एकत्रितपणे|NN ,|PUNC दमण|NNP ,|PUNC दीव|NNP आणि|CCD दादरा|NN व|CCD नगर|NN हवेली|NN यांची|PRP तुलना|NN होऊ|VM शकते|VAUX .|PUNC
एक|QTC अद्भुत|JJ प्रवेशद्वार|NN ,|PUNC दमण|NNP गंगा|NNP व्हँली|NN रिसाँर्ट|NN ,|PUNC सिल्वासा|NNP मध्ये|RPD अतिशय|INTF उत्तम|JJ खोल्या|NN ,|PUNC अणि|NN रोमन|NN पद्धतीची|NN सजावट|NN आहे|VM .|PUNC
दमण|NNP गंगा|NNP व्हँली|NNP रिसाँर्ट|NN मधील|NN दोन|QTC हनीमून|NN स्वीट्स|NN त्यातील|PRL खास|JJ बनवलेले|VM शैलीदार|NN फर्नीचर|NN ,|PUNC सुशोभित|JJ बिछाने|NN आणि|CCD प्रेमाने|NN एकमेकांच्या|NN डोळ्यात|NN टक|NN लाऊन|NN पहात|NN बसण्यासाठी|VM एक|QTC सज्जा|NN यांमुळे|PRL तुम्हाला|PRP जणु|NN राजा|NN राणीच|NNP असल्यासारखं|VM भासवतात|VAUX .|PUNC
या|DMR विश्रामगॄहामध्ये|NN आयुर्वेदीक|NN मालीश|NN केंद्र|NN व|CCD स्मारक|NN वस्तूंचं|NN दुकानही|NN आहे|VM .|PUNC
येथे|DMD एक|QTC छान|JJ तलावाशेजारील|NN उपाहारगॄह|NN सुद्धा|NN आहे|VM आणि|CCD यथील|NN उद्यानामधे|NN शेकोटीभोवती|NN मस्त|NN बार्बेक्यू|NN मिळतात|VM .|PUNC
दमणगंगा|NNP नदीच्या|NN तीरावर|NN एका|QTC पोर्तुगीज|NN पद्धतीच्या|NN इमारतीमध्ये|NN ,|PUNC रास|NN रिसॉर्ट|NN आहे|VM .|PUNC
अभिरुचीने|NN सजवलेल्या|VAUX खोल्यांमधून|NN नदीचा|NN किंवा|CCD छान|JJ निगा|NN राखलेल्या|VM हिरवळीचा|NN देखावा|NN दिसतो|VM .|PUNC
तुम्ही|PRP तुमचा|PRP दिवस|NN तरण|NN तलावावर|NN ,|PUNC वाचनगॄहामध्ये|NN ,|PUNC व्यायामगॄहामध्ये|NN ,|PUNC किंवा|CCD बाष्पस्नानगॄहामध्ये|NN व्यतीत|NN करु|VM शकता|VAUX .|PUNC
शैलीदार|NN उपाहारगॄह|NN ,|PUNC बिस्ट्रो|NN अँड|NN बनयान|NN ट्री|NN मधे|NST उत्तम|JJ जेवण|NN ,|PUNC तसेच|CCD भरपूर|QTF साठा|NN असलेला|VM मदिरा|NNP कक्ष|NN आहे|VM .|PUNC
उबड्या|NN हे|DMR गुजरातच्या|NNP उंधियुचं|NN एक|QTC स्थानिक|NN रुप|NN ,|PUNC उबड्या|NN हे|DMR मातीच्या|NN भांड्यामधे|NN भाजलेल्या|VM भाज्या|NN अणि|NN शेंगांचे|NN मिश्रण|NN असतं|VM .|PUNC
सिल्वासा|NNP येथील|PRL कामत|NN '|PUNC स्|NN रिसॉर्ट|NN मधील|NN कामत|NN '|PUNC स्|NN नी|NN वाडी|NN ,|PUNC ह्या|DMR उद्यान|NN उपाहारगॄहामध्ये|NN उबड्या|NN खाऊन|VM बघा|VM .|PUNC
आदिवासी|NN समुहांजवळ|NN मनोवेधक|JJ प्रकारांच्या|NN भाज्या|NN ,|PUNC स्वादिष्ट|NN जंगली|JJ भूछत्र|NN ,|PUNC बांबूचे|NN कोंब|NN ,|PUNC निरनिराळ्या|NN पीठांपासून|NN बनवलेल्या|VM पोळ्या|NN ,|PUNC गोड्या|JJ पाण्यामधील|NN खेकडे|NN ,|PUNC आणि|CCD नदीतील|NN रोहु|NN सारखे|JJ मासे|NN व|CCD खेकडे|NN असतात|VM .|PUNC
जरी|CCS गावरानी|NN जेवण|NN उपाहारगॄह|NN व|CCD खाद्यगॄहांमध्ये|NN सहसा|NN उपलब्ध|JJ नसलं|VM ,|PUNC तरी|CCS डाबराच्या|NN खेडेगावामधील|NN छोट्या|JJ धाब्यामधे|NN ते|DMR सहज|NN मिळतं|VM .|PUNC
हरभ|NNP ~|NN याच्या|PRP पिठाच्या|NN उकडलेल्या|VM चौकोनी|JJ वड्या|NN ,|PUNC खमण|NN सिल्वासामध्ये|NN अतिशय|INTF प्रसिद्ध|JJ आहेत|VM .|PUNC
खमण|NN आणि|CCD गुजराथी|NNP पद्धतीच्या|NN मिष्टान्नासाठी|NN ,|PUNC पंचायत|NN मार्केट|NN मधील|NN स्थानिक|NN लोकांच्या|NN आवडत्या|NN ,|PUNC साई|NN भोजनालय|NN उपाहारगॄहाला|NN भेट|NN द्या|VM .|PUNC
सागरी|NN अन्नापासून|NN बनवलेल्या|VM अतिशय|INTF आनंददायी|JJ पदार्थांसाठी|NN ,|PUNC पातिओ|NN ह्या|DMR अत्यंत|INTF साध्या|JJ ठीकाणाला|NN भेट|NN द्या|VM .|PUNC
पापलेट|NN मसाला|NN आणि|CCD मसालेदार|JJ कोलंबी|NN विशेष|JJ चवदार|NN असतात|VM .|PUNC
छान|JJ भेटवस्तू|NN खरेदी|NN करण्यासाठी|VM किंवा|CCD गावाचं|NN जवळून|NN दर्शन|NN घेण्यासाठी|VM बाजाराला|NN भेट|NN द्या|VM .|PUNC
जरी|CCS दादरा|NN आणि|CCD नगर|NN हवेली|NN हे|DMR सर्वसामान्यपणे|RB खरेदीचं|NN स्थळ|NN नसलं|VM ,|PUNC तरी|CCS येथे|DMD काही|QTF वैशिष्ट्यपूर्ण|NN आणि|CCD अस्सल|NN वस्तूंची|NN योग्य|JJ किमतीला|NN खरेदी|NN करता|VM येते|VAUX .|PUNC
थोडा|QTF वेळ|NN काढून|VM अशी|JJ काही|QTF रत्न|NN दडवलेला|VM बाजार|NN शोधण्यासाठी|VM हे|DMR स्थळ|NN पिंजून|VM काढा|NN .|PUNC
तरी|CCS सुद्धा|NN ,|PUNC सिल्वासामधील|NN ट्रायबल|NN कल्चरल|NN म्युझियम|NN ,|PUNC हे|DMR नक्कीच|NN भेट|NN द्यावी|VM असं|NN हस्तव्यवसाय|NN केंद्र|NN आहे|VM .|PUNC
ह्या|DMR वस्तुसंग्रहालया|NN मध्ये|RPD तुम्हाला|PRP अतिशय|INTF उत्तमप्रकारे|NN विणलेल्या|VM बांबूच्या|NN चटया|NN आणि|CCD टोपल्या|NN ,|PUNC चामड्याच्या|NN चपला|NN ,|PUNC भिंतीवर|NN लटकवण्याच्या|NN शोभेच्या|NN वस्तू|NN ,|PUNC मातीच्या|NN वस्तू|NN अणि|NN सोनेरी|JJ -|PUNC रंगीत|NN गवतापासून|NN बनवलेल्या|VM बांगड्या|NN मिळतात|VM .|PUNC
सिल्वासाची|NN नाडी|NN म्हणून|CCD ओळखल्या|VM जाणा|NN ~|NN या|DMR किल्वानी|NN रोड|NN येथे|DMD शहराचा|NN बहुतेक|QTF व्यापार|NN एकवटलेला|VM आहे|VAUX .|PUNC
कपडे|NN ,|PUNC पादत्राणे|NN ,|PUNC घड्याळे|NN आणखी|RB खूप|QTF काही|QTF खरेदी|NN करा|VM -|PUNC ह्या|DMR भागाच्या|NN आजूबाजूला|NST असणा|VM ~|NN या|DMR पुष्कळ|QTF छोट्या|JJ धाब्यांपैकी|NN एखाद्यामधे|JJ थांबा|VM .|PUNC
विविध|JJ जमातींच्या|NN देशात|NN आपल्याला|PRP फार|QTF काळ|NN उपरेपणा|NN जाणवणार|VM नाही|VAUX -|PUNC दादरा|NN व|CCD नगरहवेलीचे|NN अस्पर्श|NN सौंदर्य|NN आणि|CCD साधेपणा|NN आपल्याला|PRP लगेच|NST आकर्षित|JJ करेल|VM .|PUNC
सुट्टीतील|NN विश्रांतीस्थळ|NN म्हणून|CCD उत्तरोत्तर|NN प्रसिद्धी|NN पावत|VM असले|VAUX ,|PUNC तरी|CCS मुख्य|JJ रस्ते|NN सोडून|VM शांत|JJ आडवाटांवरील|NN भटकंती|NN ,|PUNC जेथे|DMD या|DMR वाटा|VAUX खास|NN आपल्याच|PRP सन्मानार्थ|NN बनवल्या|VM असल्याचा|VAUX आभास|NN होईल|VM ,|PUNC यातच|DMR दादरा|NN व|CCD नगरहवेलीची|NN खरी|NN मौलिकता|NN आहे|VM .|PUNC
दमणगंगा|NNP नदी|NN या|DMR छोट्या|JJ झोपाळू|NN केंद्रशासित|NN प्रदेशाला|NN दुभागते|VM ,|PUNC उत्तरेला|NN तीन|QTC प्रमुख|JJ शहरे|NN ,|PUNC सिल्वासा|NN ,|PUNC खानवेल|NNP व|CCD दादरा|NN ,|PUNC तर|CCS दक्षिणेला|NN उभे|JJ पश्चिम|NN घाट|NN .|PUNC
या|DMR छोट्याशा|JJ केंद्रशासित|NN प्रदेशाबाबत|NN हे|DMR फार|QTF कमी|QTF लोकांना|NN माहित|JJ असते|VM ,|PUNC की|CCS अबाधित|JJ वने|NN व|CCD हिरवीगार|NN कुरणे|VM यांमुळे|PRL पर्यावरण|NN पर्यटनासाठी|NN हे|DMR आदर्शवत|NN स्थान|NN आहे|VM .|PUNC
मुंबईपासून|NNP फक्त|JJ ३|QTC तासांवर|NN व|CCD सुरतपासून|NN २|QTC तासांवर|NN असलेली|VM सिल्वासा|NNP ही|DMR राजधानी|NN दिल्ली|NNP -|PUNC मुंबई|NNP हमरस्त्यावरून|NN गाडीने|NN थोड्याच|QTF अंतरावर|NN व|CCD सहज|NN पोहोचण्याजोगी|VM आहे|VAUX .|PUNC
मुलांसाठी|NN अनेक|QTF ठिकाणी|NN असलेले|VM बाग|NN -|SYM बगीचे|NN यामुळे|NN ,|PUNC दादरा|NN व|CCD नगरहवेली|NN हे|DMR कुटुंबांकरिता|NN वरदान|NN आहे|VM .|PUNC
सिल्वासा|NNP सर्कल|NN व|CCD हिरवा|JJ वन|NN बाग|NN (|SYM पिपारिया|NNP येथील|PRL आदिवासी|NN देवतेवरून|NN ठेवलेले|VM नाव|NN )|SYM येथे|DMD आल्हाददायी|JJ अशी|JJ मुलांची|NN बाग|NN व|CCD छोटे|JJ प्राणिसंग्रहालाय|NN आहे|VM .|PUNC
मुलांकरिता|NN खूप|QTF उत्साहवर्धक|JJ ठरू|VM शकणारी|VAUX आणखी|RB एक|QTC जागा|NN म्हणजे|CCD वासोवा|NN लायन|NN सफारी|NN ;|PUNC सिल्वासा|NN नजिकचा|NN अरण्ये|NN व|CCD सागवानांची|NN लागवड|NN असलेला|VM मोठा|JJ प्रदेश|NN -|PUNC बंदिवासात|NN जन्मलेल्या|VM सिंहांच्या|NN वसाहतीकरिता|NN खानवेल|VM रस्ता|NN बंदिस्त|JJ केला|VM आहे|VAUX .|PUNC
या|DMR बंदिस्त|JJ जागेतील|NN मिनिबसमधील|NN सफर|NN सिंहांना|NN त्यांच्या|PRP नैसर्गिक|JJ वातावरणात|NN पहाण्याची|VAUX उत्साहवर्धक|JJ संधी|NN देते|VM ,|PUNC व|CCD आपल्याला|PRP गीरच्या|NN जंगलात|NN असतानाचे|VM काही|QTF क्षण|NN आठवतात|VM .|PUNC
आणखी|RB एक|QTC चांगला|JJ पर्याय|NN म्हणजे|CCD ट्रीट|NN रिसॉर्ट|NN ,|PUNC जेथे|DMD बाग|NN ,|PUNC डिस्कोथेक|NN ,|PUNC तलाव|NN आणि|CCD अनेक|QTF प्रकारचे|NN अंतर्गत|JJ व|CCD बाह्य|JJ खेळ|NN आहेत|VM .|PUNC
दादरा|NNP व|CCD नगर|NN हवेली|NN येथील|PRL विश्रांतिस्थळे|NN सिनेमा|NN निर्मात्यांमधेही|NN प्रसिद्ध|JJ आहेत|VM ,|PUNC ज्यांना|PRL मुंबईबाहेरील|NN चित्रिकरणाकरिता|NN ही|DMR स्थळे|NN सोयीची|NN वाटतात|VM .|PUNC
सिल्वासाच्या|NNP आजुबाजुला|NN असणारी|VM छोटीछोटी|JJ आदिवासी|NN खेडी|NN पहायला|NN मिळणे|VM हा|DMR बोनसच|NN होय|VM .|PUNC
